. . . b . . . . . .
. . . b . . c . . .
b b b b . . . . . .
. . . . t b b b b b
. . c . . c l b t s
. . . c t b b b b b
. . . c b . . . . .
. . . c l l l e j j
. . . j b . . . . .
. . . t b . t . . .
