s . . . . . . . . .
j j j j j j j j j j
. . . j b b b j . .
. . . j b t b j . .
. . . j b e b j . .
. . . j b t b j . .
. . . j j . j j . .
. . . j . . . j . .
. . . j . . . j . .
. . . j . . . j . .
