. . . . . . . . . .
. . . . . . . . . .
. . . . . . . . . .
. . . . j l l . e .
. . . . l j j . . .
. . . l l l l b b b
. b b t l . . . . .
. b s t l . . . . .
. b b t l . . . . .
. . . . l . . . . .
