s . . . . b . . . .
c . . . . b . t c .
c . . . . b b b b b
c . . c . . . . . .
j b c . . . . . . .
j . j . . c . . . .
j . j b . . c . . .
j . j . b . . c . .
j . b e . l . c . .
b c t t . . b . . .
