. . . . . . l j j j
. t . . . t l j j e
. t . . t . l j j l
. t . t . . l l j j
. t t t . c . . l l
. t . t c . c . . .
. t t s . . . c . .
. . c c c c c c c .
. c . . . . . . . c
. . . . . . . . . .
